NO resources/assets/wall_1.xpm
SO resources/assets/wall_2.xpm
WE resources/assets/wall_3.xpm
EA resources/assets/wall_4.xpm

F 184,113,39
C 51,198,227

  1 1 1 1
    1 N 0 1
 1 0 0 1
1111