---start---
w_1 resources/assets/wall_1.png
w_2 resources/assets/wall_2.png
w_3 resources/assets/wall_3.png
w_4 resources/assets/wall_4.png
sky resources/assets/sky_1.xpm
flr resources/assets/floor_1.xpm
d_1 resources/assets/door01.xpm
d_s resources/assets/door_side_01.xpm

---start---
#floor and ceil.
F sky flr

#Walls
W 1 w_1 w_2 w_3 w_4
W 2 w_1 d_s w_1 w_1
W 3 d_s w_1 w_1 w_1
W 4 w_1 w_1 d_s w_1
W 5 w_1 w_1 w_1 d_s

# door
D d d_1 flr

# sprite
S s w_1 w_2 w_3

#MAP
---start---
111111111111111
100000100000001
100S0011111111111111111111
10000010000000000000010001
10000010000000000000000001
10000010000000000000010001
11101111111011111111110001
11000011000000100000010001
10000001000000100000010001
10000001000000100000010001
10000000000000111111111011111111111
10000001000000100000000000000000001
100000010000001000000000000000000011111
110000110000001001110000000000110010001
111111111111111001000000000000010010001
000000000000001000000000000000000010001
000000000000001000000000000000000010001
000000000000001000000000000000000000001
000000000000001000000000000000000010001
000000000000001000000000000000000010001
000000000000001001000000000000010010001
000000000000001001100000000000110010001
000000000000001000000000000000000010001
000000000000001000000000000000000010001
000000000000001111111111111111111110001
000000000000000000000000000000000010001
000000000000000000000000000000011110001111
000000000000000000000000000000010000000001
000111111111111100000000000000010000000001
000100000000000100000000000000010000000001
000100000000000100000000000000010000000001
000100000000000100000000000000010000000001
000100000000000100000000000000010000000001
000100000000000100000000000000010000000001
000100111111111111111111110000011111011111
000100000000000000000000010000000100001
000111100000000000000000010000000100001
000000100000000000000000010000000100001
001111100000000000011101111111111100001
001000000000000000010000000000000000001
001000100000000000010000000000000000001
001000100000000000010000000000000000001
001000111111011111110000000000000000001
001000000010001000011101111111111111111
0010000000100010000100000000001
0010000000100010000100000000001
0011110111100010000100000000001
0000100010100010000100000000001
0000100011111110000100000000001
0000100000000010000100000000001
0000111111000010000111111011111
0000000001100010000000010001
0000000000100010000000010001
0000000000010001000000010001
0000000000001000100000011111
000000000000010001
0000000000000010001
00000000000000010001
000000000000000010001111111111111111111111111111111111111
000000000000000010000010001000001000000010000000001010001
000000000000000011101010101011101011101110111011101011101
000000000000000010001000101010101000100000101010000000001
000000000000000010101110111110101111111010101110111111111
000000000000000010101010100000000010000010100010100010001
000000000000000010111011111111111010111110101111111010101
000000000000000010101010001000001010000010000010100000101
000000000000000010101010101110111011101011111110111111101
000000000000000010000010101000001000001010100010001000001
000000000000000010101010111111101110111110101111101011101
000000000000000010101000000010000010000000000010000000101
000000000000000011101010111110111010101011101110111111111
000000000000000010101010000000100000101000100000100000001
000000000000000010101110111010111010101111111110101111101
000000000000000010001000001010001010101000000010000010101
000000000000000010111011101110101011111011101110111010101
000000000000000010100010001010101000001000100010001010101
000000000000000010111010101011101111101011101111101010101
000000000000000010100010101000101000100000100010101010001
000000000000000010111010101110101110101011111110111011101
000000000000000010101010100000101000001000100010001010101
000000000000000010101110101111111110101111101110101010101
000000000000000010001000100010000000100010000010101010101
000000000000000010101011101010101111111110111110111010111
000000000000000010101010001010100000000000100000100010001
000000000000000010101011111011111111111110101111111111101
000000000000000010101000101000001000001000101000001000001
000000000000000011101110101111111010111110101010111011111
000000000000000010001000000010000010100010000010100000001
000000000000000010111111111011101010101111111110111111101
000000000000000010100000001000001010000010000010001010001
000000000000000011101010111110111011111010111111101010101
000000000000000010001010100000100000001010100000100010101
000000000000000010101110101011101111101110101110111010111
000000000000000010101000101010000010000010001000000010001
000000000000000010101011101010111011111111111010111010101
000000000000000010101000001010101000000000001010001000101
00000000000000001010111111101010101110111110101110111110111111111
00000000000000001010000010001000101000000010101000000010000000001
00000000000000001111111111111111111111111111111111111111100000001
00000000000000000000000000000000000000000000000000000000100000001
00000000000000000000000000000000000000000000000000000000100000001
00000000000000000000000000000000000000000000000000000000100000001
00000000000000000000000000000000000000000000000000000000100000001
00000000000000000000000000000000000000000000000000000000111111111
