---start---
w_1 resources/assets/wall_1.png
w_2 resources/assets/wall_2.png
w_3 resources/assets/wall_3.png
w_4 resources/assets/wall_4.png
sky resources/assets/sky_1.xpm
flr resources/assets/floor_1.xpm
d_1 resources/assets/door01.xpm
d_s resources/assets/door_side_01.xpm

---start---
#floor and ceil.
F sky flr

#Walls
W 1 w_1 w_2 w_3 w_4
W 2 w_1 d_s w_1 w_1
W 3 d_s w_1 w_1 w_1
W 4 w_1 w_1 d_s w_1
W 5 w_1 w_1 w_1 d_s

# door
D d d_1 flr

# sprite
S s w_1 w_2 w_3

#MAP
---start---
111111111111111
100000100000001
100S0011111111111111111111
10000010000000000000010001
10000000000000000d00000001
10000010000000000000010001
11101110000011110111111111
11000011000000100011
10000001000000000011
1000000d000000010001
10000001000000111111111111111111111
10000001000000100000000000000000001
10000001000000d000000000000000000011111
110000110000001001110000000000110010001
111111111111111001000000000000010010001
              1000000000000000000010001
              1000000000000000000010001
              1000000000000000000000001
              1000000000000000000010001
              1000000000000000000010001
              1001100000000000010010001
              1001100000000000110010001
              1000000000000000000010001
              1000000000000000000010001
              1111111111111111111110001
                                  10001
                               11110001111
                               10000000001
   1111111111111               10000000001
   1000000000001               10000000001
   1000000000001               10000000001
   10000d000d001               10000000001
   1000000000001               10s00000d01
   1000000000001               10000000001
   10011111111111111111111     11111d11111
   100d0000000000000000001       100001
   11110000000000000000001       100001
      10000000000000000001       100001
  11111000000000000111d1111111111100001
  1000d00d00000d00010000000000000000001
  10001000000000000d0000000000000000001
  1000100000000000010000000000000000001
  1000111111d11111110000000000000000001
  1000000010d01    111d1111111111111111
  1000000010001    100000000001
  1000000010001    100000000001
  1111111110001    100000000001
    1000110s011   100000000001
    10001111111    10000d000001
    10000000001    100000000001
    11111100001    111111011111
         110001        10001
          10001        10001
           10001       10001
            10001      11111
             10001
              10001
               10001
                10001111111111111111111111111111111111111
                10000010001000001000000010000000001010001
                11101010101011101011101110111011101011101
                10001000101010101000100000101010000000001
                10101110111110101111111010101110111111111
                10101010100000000010000010100010100010001
                10111011111111111010111110101111111010101
                10101010001000001010000010000010100000101
                10101010101110111011101011111110111111101
                10000010101000001000001010100010001000001
                10101010111111101110111110101111101011101
                10101000000010000010000000000010000000101
                11101010111110111010101011101110111111111
                10101010000000100000101000100000100000001
                10101110111010111010101111111110101111101
                10001000001010001010101000000010000010101
                10111011101110101011111011101110111010101
                10100010001010101000001000100010001010101
                10111010101011101111101011101111101010101
                10100010101000101000100000100010101010001
                10111010101110101110101011111110111011101
                10101010100000101000001000100010001010101
                10101110101111111110101111101110101010101
                10001000100010000000100010000010101010101
                10101011101010101111111110111110111010111
                10101010001010100000000000100000100010001
                10101011111011111111111110101111111111101
                10101000101000001000001000101000001000001
                11101110101111111010111110101010111011111
                10001000000010000010100010000010100000001
                10111111111011101010101111111110111111101
                10100000001000001010000010000010001010001
                11101010111110111011111010111111101010101
                10001010100000100000001010100000100010101
                10101110101011101111101110101110111010111
                10101000101010000010000010001000000010001
                10101011101010111011111111111010111010101
                10101000001010101000000000001010001000101
                1010111111101010101110111110101110111110111111111
                1010000010001000101000000010101000000010d00000001
                1111111111111111111111111111111111111111100000001
                                                        100000001
                                                        100010001
                                                        100000001
                                                        1000s0001
                                                        111111111
