---start---
w_1 resources/assets/wall_1.png
w_2 resources/assets/wall_2.png
w_3 resources/assets/wall_3.png
w_4 resources/assets/wall_4.png
w_5 resources/assets/rock01.xpm
sky resources/assets/sky_1.xpm
flr resources/assets/floor_1.xpm
d_1 resources/assets/door01.xpm
d_s resources/assets/door_side_01.xpm
brmile resources/assets/sprite_1.xpm
pillar resources/assets/pillar.xpm

---start---
#floor and ceil.
F sky flr

#Walls
W 1 w_5 w_2 w_3 w_5
W 2 w_1 d_s w_1 w_1
W 3 d_s w_1 w_1 w_1
W 4 w_1 w_1 d_s w_1
W 5 w_1 w_1 w_1 d_s

# door
D d d_1 d_s

# sprite
S s brmile
S P pillar

#MAP
---start---
111111111111111111111111111111111
100000000d00000000000000000000001
10003000300000300030000003000300111111111111
1000d0P0d00000d000d000000d000d00000000000E001
1000200020000020002000000200020000000000000001
100000000000000000000000000000000000000000001
10000000000000000000000000000000000000000001
1000300030000030003000000300030000000000001
1000d000d00000d000d000000d000d0000000000001
1000200020000020002000000200020011111111111
100000000000000000000000000000001
111111111111111111111111111111111
